no_of_cars,no_of_buses,no_of_trucks,no_of_rickshaws,no_of_bikes,no_of_vehicles,green_time
1,0,0,1,1,3,2
2,1,0,1,1,5,3
4,1,1,2,2,10,5
6,2,1,2,4,15,7
8,2,2,3,5,20,9
10,3,2,3,7,25,11
12,3,3,4,8,30,14
14,4,3,4,10,35,16
16,4,4,5,11,40,18
18,5,4,5,13,45,20
20,5,5,6,14,50,22
